PPPPPPPPPPPPPPPPPPPPPPPPPPPPPPPPPPPPPPPPPPPPPPPPPP
PRRRRRRRRRRRRRRRRRRRDDDDDDRRRRRRRRPRRPRRPRRPRRPRRP
PRRRRRRRRRRRRRRRRRRRDDWWWDRRRRRRRRPREPREPREPREPREP
PPPPPPPGGGPPPPPPPPGGDDWWWDRRRRRRRPPRBPRBPRBPRBPRBP
PGGGGGGGGGGGGGGGGPGGDDWWWDRRRRRRRRRRRRRRRRRRRRRRRP
PGGDGGGGGGGGGGGGGPGGDDWWWDRRRRRRRRRRRRRRRRRRRRRRRP
PGGGGGGGGGGGGGGGGPGGDDWWWDRRRRRRRPPRBPRBPRBPRBPRBP
PGGGGGGGDDDGGGGGGGGGDDDDDDRRRRRRRRPREPREPREPREPREP
PGDDGGGGGGGGGGGGGGGGDDDDDDRRRRRRRRPRRPRRPRRPRRPRRP
PGGGGGGGGGGGGGGGGPGGGDDDDDRRRRRRRRPPPPPPPPPPPPPPPP
PGGGGGGGGGGGGGGGGPGGGGGDDDRRRRRRRRRRRRRRRRRRRRRRRP
PPPGGGPPPPPPPPPPPPGGGGDDDDRRRRRRRRRRRRRRRRRRRRRRRP
PRRRRRRRRR   RRRRRRRDDDDDDRRRRRRRRRRRRRRRRRRRRRRRP
PRRRRRRRRR   RRRRRRRDDDDDDRRRRRRRRRRRRRRRRRRRRRRRP
PWWWWWWWWR   RRRRRRRDDDDWDRRRRRRRRRRRRRRRRRRRRRRRP
PRRRRRRRRRRRRRRRRRRRRRRRRDRRRRRRRRRRRRRRRRRRRRRRRP
PRRRRRRRRRRRRRRRRRRRRRRRRDRRRRRRRRRRRRRRRRRRRRRRRP
PRRRRRRRRRRRRRRRRRRRRRRRRDRRRRRRRRRRRRRRRRRRRRRRRP
PRRRRRRRRRRRRRRRRRRRRRRRRDRRRRRRRRRRRRRRRRRRRRRRRP
PRRRRRRRRRRRRRRRRRRRRRRRRDRRRRRRRRRRRRRRRRRRRRRRRP
PRRRRRRRRRRRRRRRRRRRRRRRRDRRRRRRRRRRRRRRRRRRRRRRRP
PRRRRRRRRRRRRRRRRRRRRRRRRDRRRRRRRRRRRRRRRRRRRRRRRP
PRRRRRRRRRRRRRRRRRRRRRRRRDRRRRRRRRRRRRRRRRRRRRRRRP
PRRRRRRRRRRRRRRRRRRRRRRRRDRRRRRRRRRRRRRRRRRRRRRRRP
PPPPPPPPPPPPPPPPPPPPPPPPPPPPPPPPPPPPPPPPPPPPPPPPPP

