DRRRRRRRRRRRRRRRRRRRRRRRR
RRRRRRRRRRRRRRRRRRRRDDDDD
RRRRRRRRRRRRRRRRRRRRDDWWW
PPPPPPPGGGPPPPPPPPGGDDWWW
GGGGGGGGGGGGGGGGGPGGDDWWW
GGGDGGGGGGGGGGGGGPGGDDWWW
GGGGGGGGGGGGGGGGGPGGDDWWW
GGGGGGGGDDDGGGGGGGGGDDDDD
GGDDGGGGGGGGGGGGGGGGDDDDD
GGGGGGGGGGGGGGGGGPGGGDDDD
GGGGGGGGGGGGGGGGGPGGGGGDD
PPPGGGPPPPPPPPPPPPGGGGDDD
RRRRRRRRRRRRRRRRRRRRDDDDD
RRRRRRRRRRRRRRRRRRRRDDDDD
WWWWWWWWWRRRRRRRRRRRDDDDW
