BBBBBBBBBBBBBBBBBBBBBBBBBBBBBBBBBBBBBBBBBBBBBBBBBB
BBBBBBBBBBBBBBBBBBBBDDDDDDBBBBBBBBBBBBBBBBBBBBBBBB
BBBBBBBBBBBBBBBBBBBBDDWWWDBBBBBBBBBBBBBBBBBBBBBBBB
BBBBBBBGGGBBBBBBBBGGDDWWWDBBBBBBBBBBBBBBBBBBBBBBBB
BGGGGGGGGGGGGGGGGBGGDDWWWDBBBBBBBBBBBBBBBBBBBBBBBB
BGGDGGGGGGGGGGGGGBGGDDWWWDBBBBBBBBBBBBBBBBBBBBBBBB
BGGGGGGGGGGGGGGGGBGGDDWWWDBBBBBBBBBBBBBBBBBBBBBBBB
BGGGGGGGDDDGGGGGGGGGDDDDDDBBBBBBBBBBBBBBBBBBBBBBBB
BGDDGGGGGGGGGGGGGGGGDDDDDDBBBBBBBBBBBBBBBBBBBBBBBB
BGGGGGGGGGGGGGGGGBGGGDDDDDBBBBBBBBBBBBBBBBBBBBBBBB
BGGGGGGGGGGGGGGGGBGGGGGDDDBBBBBBBBBBBBBBBBBBBBBBBB
BBBGGGBBBDDDDDBBBBGGGGDDDDBBBBBBBBBBBBBBBBBBBBBBBB
BBBBBBBBBDWWWDBBBBBBDDDDDDBBBBBBBBBBBBBBBBBBBBBBBB
BDDDDDDDDDWWWDBBBBBBDDDDDDBBBBBBBBBBBBBBBBBBBBBBBB
BWWWWWWWWDWWWDBBBBBBDDDDWDBBBBBBBBBBBBBBBBBBBBBBBB
BDDDDDDDDDDDDDBBBBBBBBBBBBBBBDBBBBBBBBBBBBBBBBBBBB
BBBBBBBBBBBBBBBBBBBBBBBBBDBBBBBBBBBBBBBBBBBBBBBBBB
BBBBBBBBBBBBBBBBBBBBBBBBBDBBBBBBBBBBBBBBBBBBBBBBBB
BBBBBBBBBBBBBBBBBBBBBBBBBDBBBBBBBBBBBBBBBBBBBBBBBB
BBBBBBBBBBBBBBBBBBBBBBBBBDBBBBBBBBBBBBBBBBBBBBBBBB
BBBBBBBBBBBBBBBBBBBBBBBBBDBBBBBBBBBBBBBBBBBBBBBBBB
BBBBBBBBBBBBBBBBBBBBBBBBBDBBBBBBBBBBBBBBBBBBBBBBBB
BBBBBBBBBBBBBBBBBBBBBBBBBDBBBBBBBBBBBBBBBBBBBBBBBB
BBBBBBBBBBBBBBBBBBBBBBBBBDBBBBBBBBBBBBBBBBBBBBBBBB
BBBBBBBBBBBBBBBBBBBBBBBBBBBBBBBBBBBBBBBBBBBBBBBBBB

