RRRRRRRRRRRRRRRRRRRRRRRRR
RRRRRRRRRRRRRRRRRRRRDDDDD
RRRRRRRRRRRRRRRRRRRRDDWWW
GGGGGGGGGGGGGGGGGGGGDDWWW
GGGGGGGGGGGGGGGGGGGGDDWWW
GGGGGGGGGGGGGGGGGGGGDDWWW
GGGGGGGGGGGGGGGGGGGGDDWWW
GGGGGGGGDDDGGGGGGDGGDDDDD
GGGGGGGGGGGGGGGGGGGGDDDDD
GGGGGGGGGGGGGGGGGGGGGDDDD
GGGGGGGGGGGGGGGGGGGGGGGDD
GGGGGGGGGGGGGGGGGGGGGGDDD
RRRRRRRRRRRRRRRRRRRRDDDDD
RRRRRRRRRRRRRRRRRRRRDDDDD
RRRRRRRRRRRRRRRRRRRRDDDDD