DRRRRRRRRRRRRRRRRRRRRRRRRDRRRRRRRRRRRRRRRRRRRRRRRR
RRRRRRRRRRRRRRRRRRRRDDDDDDRRRRRRRRRRRRRRRRRRRRRRRR
RRRRRRRRRRRRRRRRRRRRDDWWWDRRRRRRRRRRRRRRRRRRRRRRRR
PPPPPPPGGGPPPPPPPPGGDDWWWDRRRRRRRRRRRRRRRRRRRRRRRR
GGGGGGGGGGGGGGGGGPGGDDWWWDRRRRRRRRRRRRRRRRRRRRRRRR
GGGDGGGGGGGGGGGGGPGGDDWWWDRRRRRRRRRRRRRRRRRRRRRRRR
GGGGGGGGGGGGGGGGGPGGDDWWWDRRRRRRRRRRRRRRRRRRRRRRRR
GGGGGGGGDDDGGGGGGGGGDDDDDDRRRRRRRRRRRRRRRRRRRRRRRR
GGDDGGGGGGGGGGGGGGGGDDDDDDRRRRRRRRRRRRRRRRRRRRRRRR
GGGGGGGGGGGGGGGGGPGGGDDDDDRRRRRRRRRRRRRRRRRRRRRRRR
GGGGGGGGGGGGGGGGGPGGGGGDDDRRRRRRRRRRRRRRRRRRRRRRRR
PPPGGGPPPPPPPPPPPPGGGGDDDDRRRRRRRRRRRRRRRRRRRRRRRR
RRRRRRRRRR   RRRRRRRDDDDDDRRRRRRRRRRRRRRRRRRRRRRRR
RRRRRRRRRR   RRRRRRRDDDDDDRRRRRRRRRRRRRRRRRRRRRRRR
WWWWWWWWWR   RRRRRRRDDDDWDRRRRRRRRRRRRRRRRRRRRRRRR
DRRRRRRRRRRRRRRRRRRRRRRRRDRRRRRRRRRRRRRRRRRRRRRRRR
DRRRRRRRRRRRRRRRRRRRRRRRRDRRRRRRRRRRRRRRRRRRRRRRRR
DRRRRRRRRRRRRRRRRRRRRRRRRDRRRRRRRRRRRRRRRRRRRRRRRR
DRRRRRRRRRRRRRRRRRRRRRRRRDRRRRRRRRRRRRRRRRRRRRRRRR
DRRRRRRRRRRRRRRRRRRRRRRRRDRRRRRRRRRRRRRRRRRRRRRRRR
DRRRRRRRRRRRRRRRRRRRRRRRRDRRRRRRRRRRRRRRRRRRRRRRRR
DRRRRRRRRRRRRRRRRRRRRRRRRDRRRRRRRRRRRRRRRRRRRRRRRR
DRRRRRRRRRRRRRRRRRRRRRRRRDRRRRRRRRRRRRRRRRRRRRRRRR
DRRRRRRRRRRRRRRRRRRRRRRRRDRRRRRRRRRRRRRRRRRRRRRRRR
DRRRRRRRRRRRRRRRRRRRRRRRRDRRRRRRRRRRRRRRRRRRRRRRRR

